#########
#1 2 3# #
# ### ###
#0 1#2#5#
# ##### #
#1#2#5#6#
# ##### #
#2 3 4 5#
#########