#######
# # # #
# # ###
#   # #
#######